1 13 31
###############################
#p     *b *  1 *   *  * * *   #
# # # #*# # #*#*# # # #*#*#*# #
#   *     ***  *  1   *   * * #
# # # # # # # # #*#*# # # # #*#
#f     2   x **  *  *         #
# # # # # # # # # #*# #*# # # #
#*  *      *  *   1  *        #
# # # # #*# # # #*#*# # # #2# #
#*    **  *       *           #
# #*# #s# # # # #*# # # # # # #
#    1      *   *  *   4      #
###############################
