3 13 31
###############################
#b# # #f# #  1  #*#*# #*# #*#x#
#           # *    ** #     # #
#  #*# # * #3 #  #    #  *# * #
#  * p* *   #   #     *  *  # #
#  #   #  *  * *  #   #  b  # #
#  *    *     #    #  *  *  *3#
#  #    #    * s   1  # # *4###
#  *   *    # * #  #  *       #
#  ## #    #  *  #    #*#*# # #
#4*    *  2b  #    *#   b     #
#    # # 2      #   f     **  #
###############################