3 13 31
###############################
#b# # #f#f#  1  #*#*# #*#b#*#x#
#             *    **     3 #5#         
#  #*#     #     #    #     * #
#  * p* *   #   #     *  *  #4#
#  #   #  *  * *  #   #  b  # #
#  *    *     #    #  *  *  # #
#  #    #    * s   3  #   * ###
#  *   *    # 3 #  #  *       #
#  ##f#    #     #    #*#*# # #
#      *   b  #    *    b     #
#    #2#        #   f     *   #
###############################