2 13 31
###############################
# #b#*#*#s#*#    1    #*#*#f#*#
# #                           #
# 1#*#   # #     # *  #*#*#f# #
# #*  f  # * #f# b *  *   * f #
#  #   #   #  p *# *  #     # #
# #*    s  *     s *  *#b#*#* #
#  #    #  #  #  #  * #       #
# #b   *   * #*# *  * *  ####s#
#  #  #3 # #     #    #  #2   #
# #*#b   # #*#*#*# *  *  # x  #
#           *3    *      #   5#
###############################