2 13 31
###############################
# # #*#*# #*#    1    #*#*# #*#
# #           *  *  #        p#
#  #*#   # #     # *  #*#*# # #
# #*  f  # * # # b *  * s *   #
#  #   #   # f  *# *  #     # #
# #*       *  4    *  *# #*#* #
#3 #2   #  #  #  #  * ##      #
# #*   *   * #*# *  * *  ####*#
#  #  #  # #     #  # #  #    #
# #*#b   # #*#*#*# *  *  # x  #
#           *3    *      #   4#
###############################