2 13 31
###############################
# #b#*#*# #*#    1    #*#*#f#*#
# #                           #
# 1#*#   # #     # *  #*#*#f# #
# #*  f  # * #f# b *  *   * f #
#  #   #   #  p *# *  #     # #
# #*       *       *  *#b#*#* #
#  #    #  #  #  #  * #       #
# #b   *   * #*# *  * *  ####s#
#  #  #3 # #     #    #  #2   #
# #*#b   # #*#*#*# *  *  # x  #
#           *3    *      #   5#
###############################